40,20,2
#L0
SSSSSSSSSSSSSSSSSSSSSSSSSSSSSSSSSSSSSSSS
SWWWWWWWWWWWWWWWWWWWWWWWWWWWWWWWWWWWWWWS
SWWWWWWWWWWWWWWWWWWWWWWWWWWWWWWWWWWWWWWS
SWWWWWWWWWWWWWWWWWWWWWWWWWWWWWWWWWWWWWWS
SWWWWWWWWWWWWWWWWWWWWWWWWWWWWWWWWWWWWWWS
SWWWWWWWWWWWWWWWWWWWWWWWWWWWWWWWWWWWWWWS
SWWWWWWWWWWWWWWWWWWWWWWWWWWWWWWWWWWWWWWS
SWWWWWWWWWWWWWWWWWWWWWWWWWWWWWWWWWWWWWWS
SWWWWWWWWWWWWWWWWWWWWWWWWWWWWWWWWWWWWWWS
SWWWWWWWWWWWWWWWWWWWWWWWWWWWWWWWWWWWWWWS
SWWWWWWWWWWWWWWWWWWWWWWWWWWWWWWWWWWWWWWS
SWWWWWWWWWWWWWWWWWWWWWWWWWWWWWWWWWWWWWWS
SWWWWWWWWWWWWWWWWWWWWWWWWWWWWWWWWWWWWWWS
SWWWWWWWWWWWWWWWWWWWWWWWWWWWWWWWWWWWWWWS
SWWWWWWWWWWWWWWWWWWWWWWWWWWWWWWWWWWWWWWS
SWWWWWWWWWWWWWWWWWWWWWWWWWWWWWWWWWWWWWWS
SWWWWWWWWWWWWWWWWWWWWWWWWWWWWWWWWWWWWWWS
SWWWWWWWWWWWWWWWWWWWWWWWWWWWWWWWWWWWWWWS
SWWWWWWWWWWWWWWWWWWWWWWWWWWWWWWWWWWWWWWS
SSSSSSSSSSSSSSSSSSSSSSSSSSSSSSSSSSSSSSSS
#L1
........................................
........................................
........................................
........................................
........................................
.........SSS..........SSS..........SSS..
........................................
........................................
........................................
........................................
........................................
........................................
........................................
.......................................X
.....................................SSS
........................................
........................................
.O......................................
SSS.....................................
........................................
