20,11,2
#L0
SSSSSSSSSSSSSSSSSSSS
SWWWWWWWWWWWSWWWWWXS
SWWWWWWWWSSSSWWWSSSS
SWWWWWWWSWWWWWWSWWWS
SWWWWWWWSWWWWWWSWWWS
SWWWWWWWSSSSSWWSWSSS
SWWWWWSWWWWWWWWWWWWS
SWWWWWSWWWWWWSWWSWWS
SWWWSWSWWWWWWSWWSWWS
SOWWSWSWWWWWWSWWSWWS
SSSSSSSSSSSSSSSSSSSS
#L1
....................
....................
....................
....................
.........G.......GR.
....................
....................
....................
....................
....................
....................
