35,20,2
#L0
SSSSSSSSSSSSSSSSSSSSSSSSSSSSSSSSSSS
SWWWWWWWWWWWWWWWWWWWWWWWWWWWWWWWWWS
SWWWWWWWWWWWWWWWWWWWWWWWWWWWWWWWWWS
SWWWWWWWWWWWWWWWWWWWWWWWWWWWWWWWWWS
SWWWWWWWWWWWWWWWWWWWWWWWWWWWWWWWWWS
SWWWWWWWWWWWWWWWWWWWWWWWWWWWWWWWWWS
SWWWWWWWWWWWWWWWWWWWWWWWWWWWWWWWWWS
SWWWWWWWWWWWWWWWWWWWWWWWWWWWWWWWWWS
SWWWWWWWWWWWWWWWWWWWWWWWWWWWWWWWWWS
SWWWWWWWWWWWWWWWWWWWWWWWWWWWWWWWWWS
SWWWWWWWWWWWWWWWWWWWWWWWWWWWWWWWWWS
SWWWWWWWWWWWWWWWWWWWWWWWWWWWWWWWWWS
SWWWWWWWWWWWWWWWWWWWWWWWWWWWWWWWWWS
SWWWWWWWWWWWWWWWWWWWWWWWWWWWWWWWWWS
SWWWWWWWWWWWWWWWWWWWWWWWWWWWWWWWWWS
SWWWWWWWWWWWWWWWWWWWWWWWWWWWWWWWWWS
SWWWWWWWWWWWWWWWWWWWWWWWWWWWWWWWWWS
SWWWWWWWWWWWWWWWWWWWWWWWWWWWWWWWWWS
SWWWWWWWWWWWWWWWWWWWWWWWWWWWWWWWWWS
SSSSSSSSSSSSSSSSSSSSSSSSSSSSSSSSSSS
#L1
...................................
...................................
...................................
.......S...............R...........
.......S...............S...........
.......S...........................
.......S...........................
.......S...........................
...................................
...................................
...................................
.................................X.
...............................SSS.
...................................
...................................
...................................
...................................
.O.................................
SSS................................
...................................
