20,11,2
#L0
SSSSSSSSSSSSSSSSSSSS
SWWWWWWWWWWWWWWWWWOS
SWWWWWWWWWWWWWWWSSSS
SWWWWWWWWWWWWWWWWWWS
SWWWWWWWWWWWWWWWWWWS
SWWWWWWWWSWWWWWWWWWS
SWWWWWWWWSWWWWWWWWWS
SWWWWWWWWSWWWWWWWWWS
S...WWWWWSWWWWWWWWWS
SXWWWWWWWSWWWWWWWWWS
SSSSSSSSSSSSSSSSSSSS
#L1
....................
.........S..S.......
..R......S..S.......
.SSSS....S..S.......
......S.............
...SSSSSS...........
................SSS.
....................
.SSS...........S....
..........J.G..SG.P.
....................
