45,25,2
#L0
SSSSSSSSSSSSSSSSSSSSSSSSSSSSSSSSSSSSSSSSSSSSS
SWWWWWWWWWWWWWWWWWWWWWWWWWWWWWWWWWWWWWWWWWWWS
SWWWWWWWWWWWWWWWWWWWWWWWWWWWWWWWWWWWWWWWWWWWS
SWWWWWWWWWWWWWWWWWWWWWWWWWWWWWWWWWWWWWWWWWWWS
SWWWWWWWWWWWWWWWWWWWWWWWWWWWWWWWWWWWWWWWWWWWS
SWWWWWWWWWWWWWWWWWWWWWWWWWWWWWWWWWWWWWWWWWWWS
SWWWWWWWWWWWWWWWWWWWWWWWWWWWWWWWWWWWWWWWWWWWS
SWWWWWWWWWWWWWWWWWWWWWWWWWWWWWWWWWWWWWWWWWWWS
SWWWWWWWWWWWWWWWWWWWWWWWWWWWWWWWWWWWWWWWWWWWS
SWWWWWWWWWWWWWWWWWWWWWWWWWWWWWWWWWWWWWWWWWWWS
SWWWWWWWWWWWWWWWWWWWWWWWWWWWWWWWWWWWWWWWWWWWS
SWWWWWWWWWWWWWWWWWWWWWWWWWWWWWWWWWWWWWWWWWWWS
SWWWWWWWWWWWWWWWWWWWWWWWWWWWWWWWWWWWWWWWWWWWS
SWWWWWWWWWWWWWWWWWWWWWWWWWWWWWWWWWWWWWWWWWWWS
SWWWWWWWWWWWWWWWWWWWWWWWWWWWWWWWWWWWWWWWWWWWS
SWWWWWWWWWWWWWWWWWWWWWWWWWWWWWWWWWWWWWWWWWWWS
SWWWWWWWWWWWWWWWWWWWWWWWWWWWWWWWWWWWWWWWWWWWS
SWWWWWWWWWWWWWWWWWWWWWWWWWWWWWWWWWWWWWWWWWWWS
SWWWWWWWWWWWWWWWWWWWWWWWWWWWWWWWWWWWWWWWWWWWS
SWWWWWWWWWWWWWWWWWWWWWWWWWWWWWWWWWWWWWWWWWWWS
SWWWWWWWWWWWWWWWWWWWWWWWWWWWWWWWWWWWWWWWWWWWS
SWWWWWWWWWWWWWWWWWWWWWWWWWWWWWWWWWWWWWWWWWWWS
SWWWWWWWWWWWWWWWWWWWWWWWWWWWWWWWWWWWWWWWWWWWS
SWWWWWWWWWWWWWWWWWWWWWWWWWWWWWWWWWWWWWWWWWWWS
SSSSSSSSSSSSSSSSSSSSSSSSSSSSSSSSSSSSSSSSSSSSS
#L1
.............................................
.............................................
.............................................
.............................................
...........SSS.......SSS.....................
...............................R.............
.............................SSS.............
.............................................
.............................................
.............................................
.............................................
.............................................
.............................................
.......................................K.....
...U.................................SSS.....
.............................................
.............................................
.............................................
.............................................
.............................................
...........................................X.
.........................................MMM.
.........................................SSS.
.O...........................................
SSS..........................................
