20,11,2
#L0
SSSSSSSSSSSSSSSSSSSS
SWWWWWWWWWWWWWWWWWWS
SWWWWWWWWWWWWWWWWWWS
SWWWWWWWWWWWWWWWWWWS
SWWWWWWWWWWWWWWWWWWS
SWWWWWWWWWWWWWWWWWWS
SWWWWWWWWWWWWWWWWWWS
SWWWWWWWWWWWWWWWWWWS
SWWWWWWWWWWWWWWWWWWS
SWWWWWWWWWWWWWWWWWWS
SSSSSSSSSSSSSSSSSSSS
#L1
....................
....................
....................
...................R
........S..S......SS
......S.............
....S...............
.O.................X
SSS...............SS
.........G..........
....................
