20,11,2
#L0
SSSSSSSSSSSSSSSSSSSS
SWWWWWWWWWWWWWWWWWWS
SWWWWWWWWWWWWWWWWWWS
SWWWWWWWWWWWWWWWWWWS
SWWWWWWWWWWWWWWWWWWS
SWWWWWWWWWWWWWWWWWWS
SWWWWWWWWWWWWWWWWWWS
SWWWWWWWWWWWWWWWWWWS
SWWWWWWWWWWWWWWWWWWS
SWWWWWWWWWWWWWWWWWWS
SSSSSSSSSSSSSSSSSSSS
#L1
....................
....................
....................
..................X.
..............SSSSS.
...R................
.SSSS.........JJJ...
.O......J.J.........
SSS.................
....................
....................
