35,11,2
#L0
SSSSSSSSSSSSSSSSSSSSSSSSSSSSSSSSSSS
SWWWWWWWWWWWWWWWWWWWWWWWWWWWWWWWWWS
SWWWWWWWWWWWWWWWWWWWWWWWWWWWWWWWWWS
SWWWWWWWWWWWWWWWWWWWWWWWWWWWWWWWWWS
SWWWWWWWWWWWWWWWWWWWWWWWWWWWWWWWWWS
SWWWWWWWWWWWWWWWWWWWWWWWWWWWWWWWWWS
SWWWWWWWWWWWWWWWWWWWWWWWWWWWWWWWWWS
SWWWWWWWWWWWWWWWWWWWWWWWWWWWWWWWWWS
SWWWWWWWWWWWWWWWWWWWWWWWWWWWWWWWWWS
SWWWWWWWWWWWWWWWWWWWWWWWWWWWWWWWWWS
SSSSSSSSSSSSSSSSSSSSSSSSSSSSSSSSSSS
#L1
...................................
...................................
..............................R...X
..........................SSSSS.SSS
...................................
...............S...................
......S...S........................
.O.................................
SSS...............S................
...................................
...................................
