20,11
SSSSSSSSSSSSSSSSSSSS
S..................S
S..................S
S...............S..S
S...............S..S
S...............S..S
S...........S...S..S
S.......G...S...S..S
S......SSSS.S...S..S
SO.G.S......S.G.S.XS
SSSSSSSSSSSSSSSSSSSS
